1111111111111111
100000C1C1C11111
1001100101010101
1P01E00000000001
1011111111111111
