1111111111111111
1000000101011110
1001100101010101
1P01E00000000001
1111111111111111
