1111111111111111
100000C1C1C1111
1001100101010101
1P01E00000000001
1111111111111111
